Creating maze with file tests/maze3.txt

Unsolved maze:
%%%%%%%%%%%%%%%%%%%%%%%%%%%%%%%%%%%%%%%%%%%%%%%%%%%
%   %               %   %     %   %         %    S%
%%% % % %%%%%%%%% % % % % % %%% % % %%%%% %%% %%% %
%   % % %   %   % %   % % %     % % %   %   % % % %
% %%%%% % % % % %%%%%%% % %%%%%%% % %%% %%% % % % %
%   %   % %   %     %     %   % % %   %     %   % %
%%% % %%%%%%% %%%%%%% %%%%%%% % % %%% % %%%%%%%%% %
% % % % %   %           %   % %   % % % %       % %
% % % % % % %%%%%%%%%%% % % % % %%% % % %%%%%%% % %
% %   %   %       %     % %   % %   % % %   %   % %
% %%%%%%% %%%%%%% % %%%%% %%%%% % %%% % % % % %%% %
%   %     %     %   %   %     % % %   %   %   %   %
%%% % %%%%%%%%% % %%%%% % %%% % % %%% %%%%%%%%% %%%
%       %   %   %   %   %   %   %       %   %   % %
%%%%% % %%% % %%%%% % %%%%% % %%%%%%% %%% % % %%% %
%     % %   %     % %       % %   %   %   %   %   %
% %%%%% % %%%%%%% % %%%%%%%%% % % % %%% %%%%%%%%% %
% %     % %   % % % %   %   % % % %             % %
% % %%%%% % % % % % % % % % % %%% %%% % %%%%%%% % %
% % %   % % % % % % % % % % %     %   % %       % %
% % %%% % % % % % %%% % % % %%%%%%%%%%% %%%%%%%%% %
% %         %   %   % % % %     %     %   % %     %
% %%%%%%% %%%%%%%%% % % %%% %%% % %%% %%% % % %%%%%
%   %           %   % %   %   %   %   %     %   % %
%%% %%%%%%%%%%%%% % %%% % %%% %%%%% %%%%%%% % % % %
%   %     %     % % %   %   % %     %   % % % % % %
% %%% %%% % %%% % % % %%%%% %%% %%%%% % % % % % % %
%   % % %   %   % % %     %     %   % % % % % % % %
%%% % % % %%% %%%%% %%%%% %%%%%%% % % % % % %%% % %
%   % %   %   % %   %   %         %   % %     % % %
% %%% %%%%% %%% % %%% % %%%%%%% %%%%%%% %%% % % % %
%     %     %   %     %     %   %     %   % % %   %
%%%%%%% %%%%% %%%%% %%%%%%% % % % %%%%%%% %%% %%% %
%     %   % %       %     % % % %       % %     % %
% %%% %%% % %%% % %%% %%% % % %%%%%%%%% % % %%% % %
% % % % %       %   %   %   % %     % % %   %     %
% % % % %%% %%%%%%% %%%%%%%%% % %%% % % %%%%% % %%%
% %   %     %   % %   %       % %   % %   % % %   %
% %%%%%%%%%%% % % %%% % %%%%%%%%% %%% %%% % % %%%%%
% %       %   %     % % %   %       %       % %   %
% % % %%% % % %%%%%%% % %%% %%%%% % %%%%% %%% % % %
%   %   %   %           %   %     %       % % % % %
%%%%%%% %%%%%%%%%%%%% %%% %%% % %%%%%%%%%%% % %%% %
%   %   %     %     %     %   % %     %   %       %
% % % %%% %%% % %%% %%% %%% %%% % %%% %%% %%% %%%%%
% %   % %   % % %   %   % % % %   % %     %   %   %
% %%%%% % %%% %%% %%% %%% % % %%%%% %%%%%%% %%% % %
% %   %   %   %   %   %   %           %   %   % % %
% % % %%% % %%% % % %%% % %%% %%%%%%% % % % % % % %
%E  %     %     % %     %     %       % %   %   % %
%%%%%%%%%%%%%%%%%%%%%%%%%%%%%%%%%%%%%%%%%%%%%%%%%%%

Solved maze:
%%%%%%%%%%%%%%%%%%%%%%%%%%%%%%%%%%%%%%%%%%%%%%%%%%%
%   %               %   %     %   %~~~~~~~~~%~~~~S%
%%% % % %%%%%%%%% % % % % % %%% % %~%%%%%~%%%~%%%.%
%   % % %   %   % %   % % %     % %~%~~~%~~~%~%~%.%
% %%%%% % % % % %%%%%%% % %%%%%%% %~%%%~%%%~%~%~%.%
%   %   % %   %     %     %   % % %~~~%~~~~~%~~~%.%
%%% % %%%%%%% %%%%%%% %%%%%%% % % %%%~%~%%%%%%%%%.%
% % % % %   %           %   % %   %~%~%~%~~~~~~~%.%
% % % % % % %%%%%%%%%%% % % % % %%%~%~%~%%%%%%%~%.%
% %   %   %       %     % %   % %~~~%~%~%~~~%~~~%.%
% %%%%%%% %%%%%%% % %%%%% %%%%% %~%%%~%~%~%~%~%%%.%
%   %     %     %   %   %     % %~%~~~%~~~%~~~%...%
%%% % %%%%%%%%% % %%%%% % %%% % %~%%%~%%%%%%%%%.%%%
%       %   %   %   %   %   %   %~~~~~~~%...%...% %
%%%%% % %%% % %%%%% % %%%%% % %%%%%%%~%%%.%.%.%%% %
%     % %   %     % %       % %   %~~~%...%...%   %
% %%%%% % %%%%%%% % %%%%%%%%% % % %~%%%.%%%%%%%%% %
% %     % %   % % % %~~~%~~~% % % %~~~~.        % %
% % %%%%% % % % % % %~%~%~%~% %%% %%%~%.%%%%%%% % %
% % %   % % % % % % %~%~%~%~%     %~~~%.%       % %
% % %%% % % % % % %%%~%~%~%~%%%%%%%%%%%.%%%%%%%%% %
% %         %   %   %~%~%~%~~~~~%~~~~~%...% %     %
% %%%%%%% %%%%%%%%% %~%~%%%~%%%~%~%%%~%%%.% % %%%%%
%   %           %   %~%~~~%~~~%~~~%~~~%~~...%   % %
%%% %%%%%%%%%%%%% % %%%~%~%%%~%%%%%~%%%%%%%.% % % %
%   %     %     % % %~~~%~~~%~%~~~~~%...%~%.% % % %
% %%% %%% % %%% % % %~%%%%%~%%%~%%%%%.%.%~%.% % % %
%   % % %   %   % % %~~~~~%~~~~~%...%.%.%~%.% % % %
%%% % % % %%% %%%%% %%%%%~%%%%%%%.%.%.%.%~%.%%% % %
%   % %   %   % %   %   %~~~~~~...%...%.%~~...% % %
% %%% %%%%% %%% % %%% % %%%%%%%.%%%%%%%.%%%~%.% % %
%     %     %   %     %     %...%     %...%~%.%   %
%%%%%%% %%%%% %%%%% %%%%%%% %.% % %%%%%%%.%%%.%%% %
%~~~~~%   % %       %     % %.% %       %.%...  % %
%~%%%~%%% % %%% % %%% %%% % %.%%%%%%%%% %.%.%%% % %
%~%~%~% %       %   %   %   %.%     % % %...%     %
%~%~%~% %%% %%%%%%% %%%%%%%%%.% %%% % % %%%%% % %%%
%~%~~~%     %   % %   %.......% %   % %   % % %   %
%~%%%%%%%%%%% % % %%% %.%%%%%%%%% %%% %%% % % %%%%%
%~%~~.....%...%     % %.%   %       %       % %   %
%~%~%.%%%.%.%.%%%%%%% %.%%% %%%%% % %%%%% %%% % % %
%~~~%...%...%...........%   %     %       % % % % %
%%%%%%%.%%%%%%%%%%%%% %%% %%% % %%%%%%%%%%% % %%% %
%...%...%     %     %     %   % %     %   %       %
%.%.%.%%% %%% % %%% %%% %%% %%% % %%% %%% %%% %%%%%
%.%...% %   % % %   %   % % % %   % %     %   %   %
%.%%%%% % %%% %%% %%% %%% % % %%%%% %%%%%%% %%% % %
%.%   %   %   %   %   %   %           %   %   % % %
%.% % %%% % %%% % % %%% % %%% %%%%%%% % % % % % % %
%E  %     %     % %     %     %       % %   %   % %
%%%%%%%%%%%%%%%%%%%%%%%%%%%%%%%%%%%%%%%%%%%%%%%%%%%
Solution to maze is valid

Destroying maze
